Left=Links
LeftSingle=Einfach Links
LeftDouble=Doppelt Links
LeftReleased=Links loslassen
Right=Rechts
RightSingle=Einfach Rechts
RightDouble=Doppelt Rechts
RightReleased=Rechts loslassen
Up=Hoch
UpSingle=Einfach Hoch
UpDouble=Doppelt Hoch
UpReleased=Hoch loslassen
Down=Runter
DownSingle=Einfach Runter
DownDouble=Doppelt Runter
DownReleased=Runter loslassen
Throw=Werfen
ThrowSingle=Einfach Werfen
ThrowDouble=Doppelt Werfen
ThrowReleased=Werfen loslassen
Dig=Graben
DigSingle=Einfach Graben
DigDouble=Doppelt Graben
DigReleased=Graben loslassen
Special=Spezial
SpecialSingle=Einfach Spezial
SpecialDouble=Doppelt Spezial
SpecialReleased=Spezial loslassen
Special2=Spezial 2
Special2Single=Einfach Spezial 2
Special2Double=Doppelt Spezial 2
Special2Released=Spezial 2 loslassen
Update=Steuerungsupdate
ChangeDirLeft=Blickrichtung links
ChangeDirRight=Blickrichtung rehts
ShiftContents=Inventarwechsel

AddControlTarget=Steuerziel hinzufügen
SetViewObject=Sichtobjekt wählen
