Left=Left
LeftSingle=Left single
LeftDouble=Left double
LeftReleased=Left released
Right=Right
RightSingle=Right single
RightDouble=Right double
RightReleased=Right released
Up=Up
UpSingle=Up single
UpDouble=Up double
UpReleased=Up released
Down=Down
DownSingle=Down single
DownDouble=Down double
DownReleased=Down released
Throw=Throw
ThrowSingle=Throw single
ThrowDouble=Throw double
ThrowReleased=Throw released
Dig=Dig
DigSingle=Dig single
DigDouble=Dig double
DigReleased=Dig released
Special=Special
SpecialSingle=Special single
SpecialDouble=Special double
SpecialReleased=Special released
Special2=Special 2
Special2Single=Special 2 single
Special2Double=Special 2 double
Special2Released=Special 2 released
Update=Control update
ChangeDirLeft=Direction left
ChangeDirRight=Direction right
ShiftContents=Shift contents

AddControlTarget=Add control target
SetViewObject=Select view object
